1111111111111111
100100C0000C0001
10C0011111000001
1P0011E000000001
1000000000110001
1111111111111111