11111111111111111111
10010000000000000001
10C00111110000000001
1P0011E000C000000001
10000000001100000001
100000011000000C0001
111000000000B0000001
11111111111111111111