111111111111111
100100000000001
100001111100001
100011E00000001
100000000011001
100000011000001
11100P000C00B01
111111111111111