11111111111111111111
100100C0000C00000001
10C0011111000C000001
1P0011E000C00000C001
10000000001100000001
100000011000000C0001
11100000000B00000001
11111111111111111111